30 10
..............#.X.............
.W............#...............
..............############....
......###.....................
......#..######.###...........
..###.#.......#.#..#####......
..#...#..X....#...............
....O.######.#.#..............
...####.........#.......XX....
...O.............#............